111111111
1C0C000C1
111110001
10P01CCC1
111110001
100C0ECC1
111111111