111111111
1C0C000C1
1C0C00001
10P00CCC1
100C11111
100C1E001
111111111